1111111111111111
11CC000000000001
1100000000000011
1100000000000011
1100000000000011
1100000000000111
11000P00000E0C11
1111111111111111